NO textures/simonkraft/respawn_anchor_side0.xpm
SO textures/simonkraft/respawn_anchor_side4.xpm
WE textures/simonkraft/respawn_anchor_side3.xpm
EA textures/simonkraft/respawn_anchor_side2.xpm

F 15,6,40
C 35,19,73

111111111111111
11111     1000111111
    1111110000011111
1111000S0001111
111000000000111
110000000000011
100000000000001
110000000000011
111000000000111
111100000001111
111110000011111
111111000111111
111111111111111

