                           NO textures/wolfenstein/grey_stone.xpm
                        SO textures/wolfenstein/red_brick.xpm
WE textures/wolfenstein/eagle.xpm
EA textures/wolfenstein/mossy.xpm


                   F   255,128,0
C 0,0,0





111111111111111111111111
100000000000000000000001
100000000000000000000001
100000000000000000000001
100000000000000000000001
100000000000000000000001
100000000000000000000001
100000000000000000000001
100000000000000000000001
100000000000000000000001
100000000000000000000001
100000000010001000000001
100000000000000000000001
1000010000E0000000001001
100000000000000000000001
100000000000000000000001
100001000000000000000001
100000000000000000000001
100000000010000000000001
100000000000000000000001
100000000000000000000001
100000000000000000000001
100000000000000000000001
100000000000000000000001
100000000000000000000001
100000000000000000000001
111111111111111111111111
