NO textures/wolfenstein/grey_stone.xpm
SO textures/wolfenstein/purple_stone.xpm
WE textures/wolfenstein/red_brick.xpm
EA textures/wolfenstein/wood.xpm




F 78,95,120
C 020,30,0

	111111111111111111111111
	10001 10000110000000000001
	101100001110000000000001
	100100000000000000000001
111111111011000001110000000000001
100000000011000001101111100111111
11110111111111011100000010001
11110111111111011101010010001
1100000011010101110000001001
10000000000000001100000010001
1E000000000000001101010010001
11111111111110D01111111111111111
11000001110101011111011110111
11110111 110101 11111010001
111111111111111 111111111111