
                           NO textures/simonkraft/keffiah.xpm 
                        SO textures/simonkraft/palestine18.xpm
WE textures/simonkraft/palestine1.xpm
EA textures/simonkraft/palestine4.xpm


                   F   181,47,47

C 255,255,255

1111111111111111111111111111111111111111111111111111
11111100000000000000110000000000011111000000000011111111
11111100000000000000110000000000011111000000000011111111
11111100000000000000110000000000011111000000000011111111
1000111111111111111111000000N00000111111111110000001
11111               1110000000000011       100000001
1100011111111111111110000000000000001111111111111111
111111       1000000000000000000000001             1
10000011111111000000111100001100000001             1
1000000000000000000000000000000000000011111111111111
1111111111111111111111111111111111111111111111111111