                           NO textures/wolfenstein/grey_stone.xpm
                        SO textures/wolfenstein/red_brick.xpm
WE textures/wolfenstein/eagle.xpm
EA textures/wolfenstein/mossy.xpm

                   F   255,128,0
C 0,0,0

111111111111111111111111
100000000000000000000001
100000000000000000000001
100000001N00000000000101
100000000000000000000001
100000000000000000000001		
100000000000000000000001
100000111110000101010001
100000100010000000000001
100000100010000100010001
100000100010000000000001
100000111100001010100001
100000000000000000000001
100000000000000000000001
10000000000000000011111111
100000000000001	
10000000000001   1111111100001
1000000000000011110000001
100000000000000000000001
1111111D11000000000000001
100100001000000000000001
100000101000000000000001
100100001000000000000001
100111111000000000000001
100000000000000000000001
100000000000000000000001
111111111111111111111111
