                           NO textures/simonkraft/palestine4.xpm 
                        SO textures/simonkraft/palestine3.xpm
WE textures/vertopal.com_Rustic(1).xpm
EA textures/wall-_1resize_.xpm


                   F   178,34,34

C 220,220,220

111111111111111111111111
100000000000000000010011
100000111110000010100011
100000100010000000000001
100000100010000100100001
100000100010000000000001
100000111100001101000011
100000000000000000000001
100000000000000000000001
10000000000S000000000001
111111111000000000000001
100100001000000000000001
100000101000000000000001
100100001000000000000001
100111111000000000000001
111111111111111111111111
