                           NO textures/simonkraft/palestine4.xpm 
                        SO textures/simonkraft/palestine3.xpm
WE textures/simonkraft/keffiah.xpm
EA textures/simonkraft/palestine1.xpm


                   F   178,34,34

C 220,220,220

111111111111111111111111
10000000000000000001011
1000001111100T00101000011
100000100010000000000001
10000010001000010010001
100000100010000000000001
100000111100001101000011
100000000000000000000001
100000000000000000000001
10000000000S000000000001
111111111000000000000001
100100001000000000000001
100000101000000000000001
100100001000000000000001
100111111000000000000001
111111111111111111111111
