                           NO textures/simonkraft/palestine4.xpm
                        SO textures/simonkraft/palestine3.xpm
WE textures/simonkraft/keffiah.xpm
EA textures/simonkraft/palestine1.xpm


                   F   178,34,34
C 192,192,192





111111111111111111111111
100000000000000000001011
10000011D111000010101001
100000100010000000000001
100000100010000100010001
100000100010000000000001
100000111100001010100001
100000000000000000000001
100000000000000000000001
10000000000S000000000001
111111111000000000000001
100100001000000000000001
100000101000000000000001
100100001000000000000001
100111111000000000000001
111111111111111111111111
