NO textures/wolfenstein/grey_stone.xpm
SO textures/wolfenstein/purple_stone.xpm
WE textures/wolfenstein/red_brick.xpm
EA textures/wolfenstein/wood.xpm




F 78,95,120
C 020,30,0

        11111111  1111111111111111
        10001 10000110000000000001
        101100001110000000000001
        100100000000000000000001
111111111011000001110000000000001
10000000001100000110111111111111
11110111111111011100000010001
11110111111111011101010010001
11000000110101011100000010001
10000000000000001100000010001
1E000000000000001101010010001
11111111111111111111111111111
11000001110101011111011110111
11110111 110101 11111010001
11111111 1111111 111111111111