                           NO textures/wolfenstein/grey_stone.xpm
                        SO textures/wolfenstein/red_brick.xpm
WE textures/wolfenstein/eagle.xpm
EA textures/wolfenstein/mossy.xpm


                   F   255,128,0
C 0,0,0


111111
10001




