                           NO textures/simonkraft/palestine7.xpm 
                        SO textures/simonkraft/palestine5.xpm
WE textures/simonkraft/palestine12.xpm
EA textures/simonkraft/palestine19.xpm


                   F   109,155,115

C 220,220,220

111111111111111111111111111111111111111111111111
111111111111111111111111          100010001101
101010000010000010000101      11111D1101010101
11010101010100010111000111111110000000000000001
10101010100011000011110000000000000000000000111111
1000000000010000000100000000000000000000101010111
1000011000001110001D10000000100001111100000000001
1010110000000100111011000010000000000001000000001
100101010100011110110000E00001D111111110000000001
1000000000010000111100000000001D1111000000000011
100000000000000000000001111111111111111111111111
10000000000000000000001
100000000000000000000001
100000100001100000100001
111111111111111111111111

