NO ./texture/birds/1.xpm
SO ./texture/birds/2.xpm
WE ./texture/birds/3.xpm
EA ./texture/birds/4.xpm

F 180,64,100
C 2,130,255

11111111111
1111111111
10E00001
11011111
11111111